   WE                            textures/wolfenstein/eagle.png   
NO      textures/wolfenstein/grey_stone.png



SO textures/wolfenstein/red_brick.png

F   69, 222, 199

EA textures/wolfenstein/mossy.png



C 235, 198, 52

111111111111111111111111
100000000000000000000001
100000000000000000000001
1000P0000000000000000001
100000000000000000000001
100000000000000000000001
100000000000000000000001
100000111110000101010001
100000100010000000000001
100000100010000100010001
100000100010000000000001
100000111100001010100001
100000000000000000000001
100000000000000000000001
100000000000W00000000001
100000000000000000000001
100000000000000000000001
100000000000000000000001
100000000000000000000001
111111111000000000000001
100100001000000000000001
100P00101000000000000001
100100001000000000000001
10011P111000000000000001
100000000000000000000001
100000000000000000000001
111111111111111111111111
