1111111
1E00001
11111C1
1P00001
1X00X01
1111111