11111111111111
1C100000000001
1001P100001C01
1000000001C101
1E100000000001
11111111111111